X X X X X X X X X
X E E X O O O S X
X E E X O X X S X
X X O X O O X X X
X O O X X O O X X
X X O X X O O X X
X O O X X X O O X
X O O O O O O O X
X X X X X X X X X