X X X X X X X X X
X S S X X X X X X
X S S O X O O O X
X X X O X O X O X
X X O O X O X E X
X O O X X O X E X
X O X X X O O X X
X O O O O O O X X
X X X X X X X X X